10 10
#..#.##..#
#.#####.#.
####.####.
...#.#.###
#######...
#..#.###.#
.#.#.#####
###.#.#...
#..###.##.
###...##.#
18
