10 10
##..###..#
..#.#.....
..#...####
#.....##..
..#...#..#
.##.#.##..
.......#..
..........
...#.#....
..#..#...#
1
